0,0,0,0,0,0,0,0,0,0,0,0,0,0,0,0,0,0,0,0,0,0,0,0,0,0,0,0,0,0
0,0,0,1,2,2,2,2,2,2,2,2,2,2,2,2,2,2,2,2,2,2,2,2,2,2,3,0,0,0
0,0,0,4,9,9,9,9,9,9,10,9,9,9,9,9,9,9,10,9,9,9,9,9,10,9,9,5,0,0,0
0,0,0,4,9,9,9,9,9,9,10,9,9,9,9,9,9,9,10,9,9,9,9,9,10,9,9,5,0,0,0
0,0,0,4,9,9,9,9,9,9,10,9,9,9,9,9,9,9,10,9,9,9,9,9,10,9,9,5,0,0,0
0,0,0,4,9,9,9,9,9,9,10,9,9,9,9,9,9,9,10,9,9,9,9,9,10,9,9,5,0,0,0
0,0,0,4,9,9,9,9,9,9,10,9,9,9,9,9,9,9,10,9,9,9,9,9,10,9,9,5,0,0,0
0,0,0,4,9,9,9,9,9,9,10,9,9,9,9,9,9,9,10,9,9,9,9,9,10,9,9,5,0,0,0
0,0,0,4,9,9,9,9,9,9,10,9,9,9,9,9,9,9,10,9,9,9,9,9,10,9,9,5,0,0,0
0,0,0,4,9,9,9,9,9,9,10,9,9,9,9,9,9,9,10,9,9,9,9,9,10,9,9,5,0,0,0
0,0,0,4,9,9,9,9,9,9,10,9,9,9,9,9,9,9,10,9,9,9,9,9,10,9,9,5,0,0,0
0,0,0,4,9,9,9,9,9,9,10,9,9,9,9,9,9,9,10,9,9,9,9,9,10,9,9,5,0,0,0
0,0,0,6,7,7,7,7,7,7,7,7,7,7,7,7,7,7,7,7,7,7,7,7,7,7,8,0,0,0
0,0,0,0,0,0,0,0,0,0,0,0,0,0,0,0,0,0,0,0,0,0,0,0,0,0,0,0,0,0
